12 12 12 12 12 12 12 12 12 12 12 12 12 12 12 12 12 12 12 12 12 12 12 12 12 12 12 12 12 12 12 12 12 12 12 12 12 12 12 12 12 12 12 12 12 12 12 12 12 12
12 12 12 12 12 12 12 12 12 12 12 12 12 12 12 12 12 12 12 12 12 12 12 12 12 12 12 12 12 12 12 12 12 12 12 12 12 12 12 12 12 12 12 12 12 12 12 12 12 12
12 12 12 12 12 12 12 12 12 12 12 12 12 12 12 12 12 12 12 12 12 12 12 12 12 12 12 12 12 12 12 12 12 12 12 12 12 12 12 12 12 12 12 12 12 12 12 12 12 12
12 12 12 12 12 12 12 12 12 12 12 12 12 12 12 12 12 12 12 12 12 12 12 12 12 12 12 12 12 12 12 12 12 12 12 12 12 12 12 12 12 12 12 12 12 12 12 12 12 12
12 12 12 12 12 12 12 12 12 12 12 12 12 12 12 12 12 12 12 12 12 12 12 12 12 12 12 12 12 12 12 12 12 12 12 12 12 12 12 12 12 12 12 12 12 12 12 12 12 12
12 12 12 12 12 12 12 12 12 12 12 12 12 12 12 12 12 12 12 12 12 12 12 12 12 12 12 12 12 12 12 12 12 12 12 12 12 12 12 12 12 12 12 12 12 12 12 12 12 12
12 12 12 12 12 12 12 12 12 12 12 12 12 12 12 12 12 12 12 12 12 12 12 12 12 12 12 12 12 12 12 12 12 12 12 12 12 12 12 12 12 12 12 12 12 12 12 12 12 12
12 12 12 12 12 12 12 12 12 12 12 12 12 22 20 20 20 20 20 20 20 20 20 20 20 20 20 20 20 20 20 20 20 20 20 20 20 20 20 20 20 20 20 20 20 20 20 23 12 12
12 12 12 12 12 12 12 12 12 12 12 12 12 18 10 10 10 10 41 10 10 10 10 10 10 10 10 10 10 10 10 10 10 10 10 10 10 10 10 10 10 10 10 11 10 10 10 17 12 12
12 12 12 12 12 12 12 12 12 12 12 22 20 21 10 11 10 10 41 10 10 10 10 10 10 11 10 10 10 10 10 10 10 10 10 10 10 10 11 10 10 41 10 10 14 15 15 25 12 12
12 12 12 12 12 12 12 12 12 12 12 18 10 10 10 10 10 10 41 10 10 10 10 10 10 10 10 10 10 10 10 10 10 10 10 41 10 10 10 10 10 41 10 10 17 12 12 12 12 12
12 12 12 12 12 12 12 12 12 12 12 18 10 10 10 10 10 10 41 10 10 10 10 10 10 10 10 41 41 10 10 10 10 10 10 41 10 10 10 10 10 41 41 14 13 12 12 12 12 12
12 12 12 12 12 12 12 12 12 12 12 18 10 10 41 10 41 41 41 41 41 41 10 10 10 10 10 10 10 10 10 10 10 10 10 41 10 10 10 10 10 10 10 17 12 12 12 12 12 12
12 12 12 12 12 12 12 12 12 12 12 18 41 41 41 10 10 10 10 10 10 41 10 10 10 10 10 10 10 10 10 10 10 10 10 10 10 10 10 10 10 10 10 17 12 12 12 12 12 12
12 12 12 12 12 12 12 12 12 12 12 18 10 10 41 10 41 41 41 41 10 41 10 10 10 11 10 10 10 10 10 10 10 10 10 10 10 10 10 10 10 10 10 17 12 12 12 12 12 12
12 12 12 12 12 12 12 12 12 12 12 18 41 10 10 10 10 10 10 41 10 41 10 10 10 10 10 10 10 10 10 11 10 10 10 10 10 11 10 10 10 10 10 17 12 12 12 12 12 12
12 12 12 12 12 12 12 12 12 12 12 18 41 10 10 10 41 10 41 41 41 41 10 10 10 10 10 10 10 10 10 10 10 10 10 10 10 10 10 10 10 10 10 17 12 12 12 12 12 12
12 12 12 12 12 12 12 12 12 12 12 18 41 41 41 41 41 10 41 10 10 10 10 10 10 10 10 10 10 10 10 10 10 10 10 10 10 10 10 10 10 10 10 17 12 12 12 12 12 12
12 12 12 12 12 12 12 12 12 12 12 18 10 10 10 10 10 10 41 10 10 10 11 10 10 10 10 10 10 41 10 10 10 10 10 10 10 10 10 10 10 10 10 17 12 12 12 12 12 12
12 12 12 12 12 12 12 12 12 12 12 18 10 10 10 41 41 41 41 10 10 10 10 10 10 11 10 10 10 41 10 10 10 10 10 10 10 10 10 10 10 10 10 17 12 12 12 12 12 12
12 12 12 12 12 12 12 12 12 12 12 18 10 10 10 10 10 10 10 10 10 10 10 10 10 10 10 10 10 10 10 10 10 41 41 41 41 41 41 41 41 10 10 17 12 12 12 12 12 12
12 12 12 12 12 12 12 12 12 12 12 18 10 10 10 10 10 10 10 41 10 10 10 10 10 10 10 10 10 10 10 10 10 41 10 10 10 10 10 10 10 10 10 17 12 12 12 12 12 12
12 12 12 12 12 12 12 12 12 12 12 18 10 10 11 10 10 10 10 10 10 10 10 10 10 10 10 11 10 41 10 10 10 41 10 10 10 10 11 10 10 10 10 17 12 12 12 12 12 12
12 12 12 12 12 12 12 12 12 12 12 18 10 10 10 10 10 10 10 10 10 10 10 10 10 10 10 10 10 10 10 10 10 41 10 10 10 10 10 10 10 10 10 17 12 12 12 12 12 12
12 12 12 12 12 12 12 12 12 12 12 24 15 16 10 10 10 11 10 41 10 10 10 10 11 10 10 10 10 41 41 41 41 41 10 10 10 10 10 10 10 10 10 17 12 12 12 12 12 12
12 12 12 12 12 12 12 12 12 12 12 12 12 18 10 10 10 10 10 10 10 10 10 10 10 10 10 10 10 10 10 10 10 10 10 10 10 41 10 10 10 10 10 17 12 12 12 12 12 12
12 12 12 12 12 12 12 12 12 12 12 12 12 18 10 10 10 10 10 41 10 10 10 10 10 10 10 10 10 10 10 10 10 10 10 10 10 41 10 10 10 10 10 17 12 12 12 12 12 12
12 12 12 12 12 12 12 12 12 12 12 12 12 18 10 10 10 10 10 41 10 10 10 10 10 10 10 10 10 10 10 41 10 10 10 10 10 10 10 10 10 10 10 17 12 12 12 12 12 12
12 12 12 12 12 12 12 12 12 12 12 12 12 18 10 10 10 10 10 10 10 10 10 10 10 10 10 10 10 10 10 10 10 10 10 10 10 10 10 10 10 10 10 17 12 12 12 12 12 12
12 12 12 12 12 12 12 12 12 12 12 12 12 24 15 15 15 15 15 15 15 15 15 15 15 15 16 41 41 10 10 10 10 10 14 15 15 15 15 15 15 15 15 25 12 12 12 12 12 12
12 12 12 12 12 12 12 12 12 12 12 12 12 12 12 12 12 12 12 12 12 12 12 12 12 12 18 10 11 10 11 10 14 15 25 12 12 12 12 12 12 12 12 12 12 12 12 12 12 12
12 12 12 12 12 12 12 12 12 12 12 12 12 12 12 12 12 12 12 12 12 12 12 12 12 12 18 10 10 10 10 10 17 12 12 12 12 12 12 12 12 12 12 12 12 12 12 12 12 12
12 12 12 12 12 12 12 12 12 12 12 12 12 12 12 12 12 12 12 12 12 12 12 12 12 12 24 15 15 15 15 15 25 12 12 12 12 12 12 12 12 12 12 12 12 12 12 12 12 12
12 12 12 12 12 12 12 12 12 12 12 12 12 12 12 12 12 12 12 12 12 12 12 12 12 12 12 12 12 12 12 12 12 12 12 12 12 12 12 12 12 12 12 12 12 12 12 12 12 12
12 12 12 12 12 12 12 12 12 12 12 12 12 12 12 12 12 12 12 12 12 12 12 12 12 12 12 12 12 12 12 12 12 12 12 12 12 12 12 12 12 12 12 12 12 12 12 12 12 12
12 12 12 12 12 12 12 12 12 12 12 12 12 12 12 12 12 12 12 12 12 12 12 12 12 12 12 12 12 12 12 12 12 12 12 12 12 12 12 12 12 12 12 12 12 12 12 12 12 12
12 12 12 12 12 12 12 12 12 12 12 12 12 12 12 12 12 12 12 12 12 12 12 12 12 12 12 12 12 12 12 12 12 12 12 12 12 12 12 12 12 12 12 12 12 12 12 12 12 12
12 12 12 12 12 12 12 12 12 12 12 12 12 12 12 12 12 12 12 12 12 12 12 12 12 12 12 12 12 12 12 12 12 12 12 12 12 12 12 12 12 12 12 12 12 12 12 12 12 12
12 12 12 12 12 12 12 12 12 12 12 12 12 12 12 12 12 12 12 12 12 12 12 12 12 12 12 12 12 12 12 12 12 12 12 12 12 12 12 12 12 12 12 12 12 12 12 12 12 12
12 12 12 12 12 12 12 12 12 12 12 12 12 12 12 12 12 12 12 12 12 12 12 12 12 12 12 12 12 12 12 12 12 12 12 12 12 12 12 12 12 12 12 12 12 12 12 12 12 12
12 12 12 12 12 12 12 12 12 12 12 12 12 12 12 12 12 12 12 12 12 12 12 12 12 12 12 12 12 12 12 12 12 12 12 12 12 12 12 12 12 12 12 12 12 12 12 12 12 12
12 12 12 12 12 12 12 12 12 12 12 12 12 12 12 12 12 12 12 12 12 12 12 12 12 12 12 12 12 12 12 12 12 12 12 12 12 12 12 12 12 12 12 12 12 12 12 12 12 12
12 12 12 12 12 12 12 12 12 12 12 12 12 12 12 12 12 12 12 12 12 12 12 12 12 12 12 12 12 12 12 12 12 12 12 12 12 12 12 12 12 12 12 12 12 12 12 12 12 12
12 12 12 12 12 12 12 12 12 12 12 12 12 12 12 12 12 12 12 12 12 12 12 12 12 12 12 12 12 12 12 12 12 12 12 12 12 12 12 12 12 12 12 12 12 12 12 12 12 12
12 12 12 12 12 12 12 12 12 12 12 12 12 12 12 12 12 12 12 12 12 12 12 12 12 12 12 12 12 12 12 12 12 12 12 12 12 12 12 12 12 12 12 12 12 12 12 12 12 12
12 12 12 12 12 12 12 12 12 12 12 12 12 12 12 12 12 12 12 12 12 12 12 12 12 12 12 12 12 12 12 12 12 12 12 12 12 12 12 12 12 12 12 12 12 12 12 12 12 12
12 12 12 12 12 12 12 12 12 12 12 12 12 12 12 12 12 12 12 12 12 12 12 12 12 12 12 12 12 12 12 12 12 12 12 12 12 12 12 12 12 12 12 12 12 12 12 12 12 12
12 12 12 12 12 12 12 12 12 12 12 12 12 12 12 12 12 12 12 12 12 12 12 12 12 12 12 12 12 12 12 12 12 12 12 12 12 12 12 12 12 12 12 12 12 12 12 12 12 12
12 12 12 12 12 12 12 12 12 12 12 12 12 12 12 12 12 12 12 12 12 12 12 12 12 12 12 12 12 12 12 12 12 12 12 12 12 12 12 12 12 12 12 12 12 12 12 12 12 12
12 12 12 12 12 12 12 12 12 12 12 12 12 12 12 12 12 12 12 12 12 12 12 12 12 12 12 12 12 12 12 12 12 12 12 12 12 12 12 12 12 12 12 12 12 12 12 12 12 12
